                  , ,t            G,t ,, , 
                  =====          ========= 
H      ,B,P ,,,t  , G , ,,  t   ,  ,,,G ,, 
===========================================
...........................................