                  ,t,F             ,tF,, , 
                  =====        F ========= 
H      ,B,P ,,,t  , G , ,,  t   ,  ,,,G ,, 
===========================================
...........................................