                         F ,,                                             
                           ---                                , ,Gt,,,    
                              ,t,F             ,tF,,,s       ---------    
          P                   -----        F ---------        F           
H      ,B,  ,,, === ,,,t,,,   , G , ,,  t   ,  ,,,G ,, ,  , , ,, ,  ,,,tG,
================...=======================================================
..........................................................................
..........................................................................